#######################################
# Syntax Coloring Map
#######################################

#######################################
# Datatypes (KEYWORD1)
#######################################

EPAPER	KEYWORD1
EPAPER_154	KEYWORD1
EPAPER_420	KEYWORD1
EPAPER_750	KEYWORD1

#######################################
# Methods and Functions (KEYWORD2)
#######################################

begin	KEYWORD2
powerOn	KEYWORD2
powerOff	KEYWORD2
reset	KEYWORD2
setFreq	KEYWORD2
delayWhileBusy	KEYWORD2
isBusy	KEYWORD2
sendBW	KEYWORD2
sendR	KEYWORD2
refreshDisplay	KEYWORD2
updateDisplay	KEYWORD2
bmpFromSD	KEYWORD2
saveToSD	KEYWORD2
loadFromSD	KEYWORD2
fillFromArray	KEYWORD2
lineFromArray	KEYWORD2
fillFromArray	KEYWORD2
lineFromArray	KEYWORD2
pixel	KEYWORD2
xline	KEYWORD2
yline	KEYWORD2
rectangle	KEYWORD2
fillScreen	KEYWORD2
line	KEYWORD2
polygon	KEYWORD2
circle	KEYWORD2
fillWindow	KEYWORD2
sendCommand	KEYWORD2
sendData	KEYWORD2
setLutBw	KEYWORD2
setLutRed	KEYWORD2
_sendBW	KEYWORD2
_sendR	KEYWORD2
_sendBWR	KEYWORD2
_bmp24	KEYWORD2
beginSRAM	KEYWORD2
readSRAM	KEYWORD2
writeSRAM	KEYWORD2
hwpixel	KEYWORD2
hwxline	KEYWORD2
hwyline	KEYWORD2
getOffsetColor	KEYWORD2

#######################################
# Constants (LITERAL1)
#######################################

SPARKFUN_EPAPER_H	LITERAL1
SPARKFUN_EPAPER_154_H	LITERAL1
SPARKFUN_EPAPER_420_H	LITERAL1
SPARKFUN_EPAPER_750_H	LITERAL1
PANEL_SETTING	LITERAL1
POWER_SETTING	LITERAL1
POWER_OFF	LITERAL1
POWER_OFF_SEQUENCE_SETTING	LITERAL1
POWER_ON	LITERAL1
POWER_ON_MEASURE	LITERAL1
BOOSTER_SOFT_START	LITERAL1
DEEP_SLEEP	LITERAL1
DATA_START_TRANSMISSION_1	LITERAL1
DATA_STOP	LITERAL1
DISPLAY_REFRESH	LITERAL1
DATA_START_TRANSMISSION_2	LITERAL1
IMAGE_PROCESS_COMMAND	LITERAL1
PLL_CONTROL	LITERAL1
TEMPERATURE_SENSOR_COMMAND	LITERAL1
TEMPERATURE_SENSOR_CALIBRATION	LITERAL1
TEMPERATURE_SENSOR_WRITE	LITERAL1
TEMPERATURE_SENSOR_READ	LITERAL1
VCOM_AND_DATA_INTERVAL_SETTING	LITERAL1
LOW_POWER_DETECTION	LITERAL1
TCON_SETTING	LITERAL1
TCON_RESOLUTION	LITERAL1
SOURCE_AND_GATE_START_SETTING	LITERAL1
GET_STATUS	LITERAL1
AUTO_MEASURE_VCOM	LITERAL1
VCOM_VALUE	LITERAL1
VCM_DC_SETTING_REGISTER	LITERAL1
PROGRAM_MODE	LITERAL1
ACTIVE_PROGRAM	LITERAL1
READ_OTP_DATA	LITERAL1
READ	LITERAL1
WRITE	LITERAL1
RDSR	LITERAL1
WRSR	LITERAL1
WHITE	LITERAL1
RED	LITERAL1
BLACK	LITERAL1
